1111111111111
1P000000000E1
1000000000001
100000C000001
1111111111111