1111111111111
1C110000000C1
1000011111001
1111011C11001
1000011011001
1000011011001
1000011011001
1C00011011001
1100C11000001
1P01111111011
111111E0000C1
1111111111111
1111111111111