111111111111111
1P1000100010001
101C1C1C1C1C101
101C1C1C1C1C101
101C1C1C1C1C101
101C1C1C1C1C101
101C1C1C1C1C101
101C1C1C1C1C101
101C1C1C1C1C101
1000100010001E1
111111111111111