1111111111111111111111
1C000011111C111C111C11
1111001111101110111011
1000000000000000111011
1P11111011111110111011
1111111011101C10000011
1000111011111010111011
1C10111011111010111011
1110111011111010111011
1110C00C000000000000E1
1111111111111111111111