1111111111111
1P1000Z0001E1
1011111111101
1C0000C0000C1
1111111111111